{
	"name": "jeden",
	"floors": 10,
	"height": 10,
	"width": 10,
	"positions":
	[
		{
			"x":2,
			"y":2,
			"z":1
		},
		{
			"x":4,
			"y":4,
			"z":4
		},
		{
			"x":2,
			"y":2,
			"z":7
		}
	],
	"blocks":
	[
		[
			[1,1,1,1,1,1,1,1,1,1],
			[1,1,1,1,1,1,1,1,1,1],
			[1,1,1,1,1,1,1,1,1,1],
			[1,1,1,1,1,1,1,1,1,1],
			[1,1,1,1,1,1,1,1,1,1],
			[1,1,1,1,1,1,1,1,1,1],
			[1,1,1,1,1,1,1,1,1,1],
			[1,1,1,1,1,1,1,1,1,1],
			[1,1,1,1,1,1,1,1,1,1],
			[1,1,1,1,1,1,1,1,1,1]
		],
		[
			[1,1,1,1,1,1,1,1,1,1],
			[1,0,0,0,0,1,1,1,1,1],
			[1,0,0,0,0,1,1,1,1,1],
			[1,0,1,1,0,1,1,1,1,1],
			[1,0,0,0,0,1,1,1,1,1],
			[1,0,0,0,0,1,1,1,1,1],
			[1,0,1,1,0,1,1,1,1,1],
			[1,0,0,0,0,1,1,1,1,1],
			[1,0,0,0,0,1,1,1,1,1],
			[1,1,1,1,1,1,1,1,1,1]
		],
		[
			[1,1,1,1,1,1,1,1,1,1],
			[1,0,0,0,0,1,1,1,1,1],
			[1,0,0,0,0,1,0,1,1,1],
			[1,0,1,1,0,1,0,0,1,1],
			[1,0,0,0,0,1,0,1,1,1],
			[1,0,0,0,0,1,0,0,1,1],
			[1,0,1,1,0,1,0,1,1,1],
			[1,0,0,0,0,1,1,1,1,1],
			[1,0,0,0,0,1,1,1,1,1],
			[1,1,1,1,1,1,1,1,1,1]
		],
		[
			[1,1,1,1,1,1,1,1,1,1],
			[1,1,1,1,1,1,1,1,1,1],
			[1,1,1,1,1,1,0,1,1,1],
			[1,1,1,1,1,1,0,0,1,1],
			[1,1,1,1,1,1,0,1,1,1],
			[1,1,1,1,1,1,0,0,1,1],
			[1,1,1,1,1,1,0,1,1,1],
			[1,1,1,1,1,1,1,1,1,1],
			[1,1,1,1,1,1,1,1,1,1],
			[1,1,1,1,1,1,1,1,1,1]
		],
		[
			[1,1,1,1,1,1,1,1,1,1],
			[1,1,1,1,1,1,1,1,1,1],
			[1,1,1,0,0,0,0,1,1,1],
			[1,1,0,0,0,0,0,0,1,1],
			[1,1,0,0,0,0,0,1,1,1],
			[1,1,0,0,0,0,0,0,1,1],
			[1,1,1,0,0,0,0,1,1,1],
			[1,1,1,1,1,1,1,1,1,1],
			[1,1,1,1,1,1,1,1,1,1],
			[1,1,1,1,1,1,1,1,1,1]
		],
		[
			[1,1,1,1,1,1,1,1,1,1],
			[1,1,1,1,1,1,1,1,1,1],
			[1,1,1,0,0,0,0,1,1,1],
			[1,1,0,0,0,0,0,0,1,1],
			[1,1,0,0,0,0,0,1,1,1],
			[1,1,0,0,0,0,0,0,1,1],
			[1,1,1,0,0,0,0,1,1,1],
			[1,1,1,1,1,1,1,1,1,1],
			[1,1,1,1,1,1,1,1,1,1],
			[1,1,1,1,1,1,1,1,1,1]
		],
		
		[
			[1,1,1,1,1,1,1,1,1,1],
			[1,1,1,1,1,1,1,1,1,1],
			[1,1,1,1,1,1,1,1,1,1],
			[1,1,1,1,1,1,1,1,1,1],
			[1,1,1,1,1,1,1,1,1,1],
			[1,1,1,1,1,1,1,1,1,1],
			[1,1,1,1,1,1,1,1,1,1],
			[1,1,1,1,1,1,1,1,1,1],
			[1,1,1,1,1,1,1,1,1,1],
			[1,1,1,1,1,1,1,1,1,1]
		],
		[
			[1,1,1,1,1,1,1,1,1,1],
			[1,1,1,0,0,0,0,0,1,1],
			[1,1,0,0,0,0,1,0,0,1],
			[1,1,0,0,0,0,1,0,0,1],
			[1,0,0,0,0,0,1,1,1,1],
			[1,0,0,0,0,0,0,0,0,1],
			[1,1,0,0,0,0,0,0,0,1],
			[1,1,0,0,0,0,0,0,0,1],
			[1,1,1,0,0,0,0,0,1,1],
			[1,1,1,1,1,1,1,1,1,1]
		],
		[
			[1,1,1,1,1,1,1,1,1,1],
			[1,1,1,0,0,0,0,0,1,1],
			[1,1,0,0,0,0,1,0,0,1],
			[1,1,0,0,0,0,1,0,0,1],
			[1,0,0,0,0,0,1,1,1,1],
			[1,0,0,0,0,0,0,0,0,1],
			[1,1,0,0,0,0,0,0,0,1],
			[1,1,0,0,0,0,0,0,0,1],
			[1,1,1,0,0,0,0,0,1,1],
			[1,1,1,1,1,1,1,1,1,1]
		],
		[
			[1,1,1,1,1,1,1,1,1,1],
			[1,1,1,1,1,1,1,1,1,1],
			[1,1,1,1,1,1,1,1,1,1],
			[1,1,1,1,1,1,1,1,1,1],
			[1,1,1,1,1,1,1,1,1,1],
			[1,1,1,1,1,1,1,1,1,1],
			[1,1,1,1,1,1,1,1,1,1],
			[1,1,1,1,1,1,1,1,1,1],
			[1,1,1,1,1,1,1,1,1,1],
			[1,1,1,1,1,1,1,1,1,1]
		]
	]
}
