{
	"name": "jeden",
	"floors": 10,
	"height": 10,
	"width": 10,
	"blocks":
	[
		[
			[1,1,1,1,1,1,1,1,1,1],
			[1,0,0,0,0,1,0,0,0,1],
			[1,0,0,0,0,1,0,0,0,1],
			[1,0,0,0,0,1,0,0,0,1],
			[1,0,0,0,0,1,0,0,0,1],
			[1,0,0,0,0,1,0,0,0,1],
			[1,0,0,0,0,1,0,0,0,1],
			[1,0,0,0,0,1,0,0,0,1],
			[1,0,0,0,0,1,0,0,0,1],
			[1,1,1,1,1,1,1,1,1,1]
		],
		[
			[1,1,1,1,1,1,1,1,1,1],
			[1,0,0,0,0,1,0,0,0,1],
			[1,0,0,0,0,1,0,0,0,1],
			[1,0,0,0,0,1,0,0,0,1],
			[1,0,0,0,0,1,0,0,0,1],
			[1,0,0,0,0,1,0,0,0,1],
			[1,0,0,0,0,1,0,0,0,1],
			[1,0,0,0,0,1,0,0,0,1],
			[1,0,0,0,0,1,0,0,0,1],
			[1,1,1,1,1,1,1,1,1,1]
		],
		[
			[1,1,1,1,1,1,1,1,1,1],
			[1,0,0,0,0,1,0,0,0,1],
			[1,0,0,0,0,1,0,0,0,1],
			[1,0,0,0,0,1,0,0,0,1],
			[1,0,0,0,0,1,0,0,0,1],
			[1,0,0,0,0,1,0,0,0,1],
			[1,0,0,0,0,1,0,0,0,1],
			[1,0,0,0,0,1,0,0,0,1],
			[1,0,0,0,0,1,0,0,0,1],
			[1,1,1,1,1,1,1,1,1,1]
		],
		[
			[1,1,1,1,1,1,1,1,1,1],
			[1,1,1,1,1,1,0,0,0,1],
			[1,1,1,1,1,1,0,0,0,1],
			[1,1,1,1,1,1,0,0,0,1],
			[1,1,1,1,1,1,0,0,0,1],
			[1,1,1,1,1,1,0,0,0,1],
			[1,1,1,1,1,1,0,0,0,1],
			[1,1,1,1,1,1,0,0,0,1],
			[1,1,1,1,1,1,0,0,0,1],
			[1,1,1,1,1,1,1,1,1,1]
		],
		[
			[1,1,1,1,1,1,1,1,1,1],
			[1,0,0,0,0,0,0,0,0,1],
			[1,0,0,0,0,0,0,0,0,1],
			[1,0,0,0,0,0,0,0,0,1],
			[1,0,0,0,0,0,0,0,0,1],
			[1,0,0,0,0,0,0,0,0,1],
			[1,0,0,0,0,0,0,0,0,1],
			[1,0,0,0,0,0,0,0,0,1],
			[1,0,0,0,0,0,0,0,0,1],
			[1,1,1,1,1,1,1,1,1,1]
		],
		[
			[1,1,1,1,1,1,1,1,1,1],
			[1,0,0,0,0,0,0,0,0,1],
			[1,0,0,0,0,0,0,0,0,1],
			[1,0,0,0,0,0,0,0,0,1],
			[1,0,0,0,0,0,0,0,0,1],
			[1,0,0,0,0,0,0,0,0,1],
			[1,0,0,0,0,0,0,0,0,1],
			[1,0,0,0,0,0,0,0,0,1],
			[1,0,0,0,0,0,0,0,0,1],
			[1,1,1,1,1,1,1,1,1,1]
		],
		[
			[1,1,1,1,1,1,1,1,1,1],
			[1,0,0,0,0,0,0,0,0,1],
			[1,0,0,0,0,0,0,0,0,1],
			[1,0,0,0,0,0,0,0,0,1],
			[1,0,0,0,0,0,0,0,0,1],
			[1,0,0,0,0,0,0,0,0,1],
			[1,0,0,0,0,0,0,0,0,1],
			[1,0,0,0,0,0,0,0,0,1],
			[1,0,0,0,0,0,0,0,0,1],
			[1,1,1,1,1,1,1,1,1,1]
		],
		[
			[1,1,1,1,1,1,1,1,1,1],
			[1,1,1,1,1,1,1,1,1,1],
			[1,1,1,1,1,1,1,1,1,1],
			[1,1,1,0,0,0,0,1,1,1],
			[1,1,1,0,1,1,0,1,1,1],
			[1,1,1,0,1,1,0,1,1,1],
			[1,1,1,0,1,1,0,1,1,1],
			[1,1,1,1,1,1,1,1,1,1],
			[1,1,1,1,1,1,1,1,1,1],
			[1,1,1,1,1,1,1,1,1,1]
		],
		[
			[1,1,1,1,1,1,1,1,1,1],
			[1,0,0,0,0,0,0,0,0,1],
			[1,0,0,0,0,0,0,0,0,1],
			[1,0,0,0,0,0,0,0,0,1],
			[1,0,0,0,0,0,0,0,0,1],
			[1,0,0,0,0,0,0,0,0,1],
			[1,0,0,0,0,0,0,0,0,1],
			[1,0,0,0,0,0,0,0,0,1],
			[1,0,0,0,0,0,0,0,0,1],
			[1,1,1,1,1,1,1,1,1,1]
		],
		[
			[1,1,1,1,1,1,1,1,1,1],
			[1,0,0,0,0,0,0,0,0,1],
			[1,0,0,0,0,0,0,0,0,1],
			[1,0,0,0,0,0,0,0,0,1],
			[1,0,0,0,0,0,0,0,0,1],
			[1,0,0,0,0,0,0,0,0,1],
			[1,0,0,0,0,0,0,0,0,1],
			[1,0,0,0,0,0,0,0,0,1],
			[1,0,0,0,0,0,0,0,0,1],
			[1,1,1,1,1,1,1,1,1,1]
		]
	]
}