{
	"name": "jeden",
	"floors": 10,
	"height": 10,
	"width": 10,
	"positions":
	[
		{
			"x":1,
			"y":1,
			"z":1
		},
		{
			"x":4,
			"y":4,
			"z":4
		},
		{
			"x":1,
			"y":1,
			"z":7
		}
	],
	"blocks":
	[
		[
			[1,1,1,1,1,1,1,1,1,1],
			[1,1,1,1,1,1,1,1,1,1],
			[1,1,1,1,1,1,1,1,1,1],
			[1,1,1,1,1,1,1,1,1,1],
			[1,1,1,1,1,1,1,1,1,1],
			[1,1,1,1,1,1,1,1,1,1],
			[1,1,1,1,1,1,1,1,1,1],
			[1,1,1,1,1,1,1,1,1,1],
			[1,1,1,1,1,1,1,1,1,1],
			[1,1,1,1,1,1,1,1,1,1]
		],
		[
			[1,1,1,1,1,1,1,1,1,1],
			[1,0,0,0,0,1,1,1,1,1],
			[1,0,0,0,0,1,1,1,1,1],
			[1,0,1,1,0,1,1,1,1,1],
			[1,0,1,1,0,1,1,1,1,1],
			[1,0,0,0,0,1,1,1,1,1],
			[1,0,0,0,0,1,1,1,1,1],
			[1,0,0,0,0,1,1,1,1,1],
			[1,0,0,0,0,1,1,1,1,1],
			[1,1,1,1,1,1,1,1,1,1]
		],
		[
			[1,1,1,1,1,1,1,1,1,1],
			[1,0,0,0,0,1,1,1,1,1],
			[1,0,0,0,0,1,0,0,1,1],
			[1,0,1,1,0,1,0,0,1,1],
			[1,0,1,1,0,1,0,0,1,1],
			[1,0,0,0,0,1,0,0,1,1],
			[1,0,0,0,0,1,0,0,1,1],
			[1,0,0,0,0,1,1,1,1,1],
			[1,0,0,0,0,1,1,1,1,1],
			[1,1,1,1,1,1,1,1,1,1]
		],
		[
			[1,1,1,1,1,1,1,1,1,1],
			[1,1,1,1,1,1,1,1,1,1],
			[1,1,1,1,1,1,0,0,1,1],
			[1,1,1,1,1,1,0,0,1,1],
			[1,1,1,1,1,1,0,0,1,1],
			[1,1,1,1,1,1,0,0,1,1],
			[1,1,1,1,1,1,0,0,1,1],
			[1,1,1,1,1,1,1,1,1,1],
			[1,1,1,1,1,1,1,1,1,1],
			[1,1,1,1,1,1,1,1,1,1]
		],
		[
			[1,1,1,1,1,1,1,1,1,1],
			[1,1,1,1,1,1,1,1,1,1],
			[1,1,0,0,0,0,0,0,1,1],
			[1,1,0,0,0,0,0,0,1,1],
			[1,1,0,0,0,0,0,1,1,1],
			[1,1,0,0,0,0,0,0,1,1],
			[1,1,0,0,0,0,0,0,1,1],
			[1,1,1,1,1,1,1,1,1,1],
			[1,1,1,1,1,1,1,1,1,1],
			[1,1,1,1,1,1,1,1,1,1]
		],
		[
			[1,1,1,1,1,1,1,1,1,1],
			[1,1,1,1,1,1,1,1,1,1],
			[1,1,0,0,0,0,0,0,1,1],
			[1,1,0,0,0,0,0,0,1,1],
			[1,1,0,0,0,0,0,1,1,1],
			[1,1,0,0,0,0,0,0,1,1],
			[1,1,0,0,0,0,0,0,1,1],
			[1,1,1,1,1,1,1,1,1,1],
			[1,1,1,1,1,1,1,1,1,1],
			[1,1,1,1,1,1,1,1,1,1]
		],
		
		[
			[1,1,1,1,1,1,1,1,1,1],
			[1,1,1,1,1,1,1,1,1,1],
			[1,1,1,1,1,1,1,1,1,1],
			[1,1,1,1,1,1,1,1,1,1],
			[1,1,1,1,1,1,1,1,1,1],
			[1,1,1,1,1,1,1,1,1,1],
			[1,1,1,1,1,1,1,1,1,1],
			[1,1,1,1,1,1,1,1,1,1],
			[1,1,1,1,1,1,1,1,1,1],
			[1,1,1,1,1,1,1,1,1,1]
		],
		[
			[1,1,1,1,1,1,1,1,1,1],
			[1,0,0,0,0,0,0,0,0,1],
			[1,0,0,0,0,0,0,0,0,1],
			[1,0,0,0,0,0,0,0,0,1],
			[1,0,0,0,0,0,0,0,0,1],
			[1,0,0,0,0,0,0,0,0,1],
			[1,0,0,0,0,0,0,0,0,1],
			[1,0,0,0,0,0,0,0,0,1],
			[1,0,0,0,0,0,0,0,0,1],
			[1,1,1,1,1,1,1,1,1,1]
		],
		[
			[1,1,1,1,1,1,1,1,1,1],
			[1,0,0,0,0,0,0,0,0,1],
			[1,0,0,0,0,0,1,0,0,1],
			[1,0,0,0,0,0,1,0,0,1],
			[1,0,0,0,0,0,1,1,1,1],
			[1,0,0,0,0,0,0,0,0,1],
			[1,0,0,0,0,0,0,0,0,1],
			[1,0,0,0,0,0,0,0,0,1],
			[1,0,0,0,0,0,0,0,0,1],
			[1,1,1,1,1,1,1,1,1,1]
		],
		[
			[1,1,1,1,1,1,1,1,1,1],
			[1,1,1,1,1,1,1,1,1,1],
			[1,1,1,1,1,1,1,1,1,1],
			[1,1,1,1,1,1,1,1,1,1],
			[1,1,1,1,1,1,1,1,1,1],
			[1,1,1,1,1,1,1,1,1,1],
			[1,1,1,1,1,1,1,1,1,1],
			[1,1,1,1,1,1,1,1,1,1],
			[1,1,1,1,1,1,1,1,1,1],
			[1,1,1,1,1,1,1,1,1,1]
		]
	]
}
