{
	"version": "0.0.0",
	"name": "Test 3",
    "levels": 8,
    "width": 5,
    "height": 5,
	"map":
	[

		[
			[0,1,1,1,0],
			[0,0,1,0,0],
			[1,0,1,0,0],
			[0,1,1,0,0],
			[0,0,1,0,0]
		],
		[
			[0,1,1,1,1],
			[0,1,0,0,0],
			[0,0,1,0,0],
			[1,0,0,1,0],
			[0,1,1,0,0]
		],
		[
			[0,0,1,1,1],
			[0,0,0,1,1],
			[1,1,1,1,1],
			[0,0,1,1,0],
			[0,1,1,1,0]
		],
		[
			[0,0,0,0,0],
			[0,1,1,1,0],
			[0,1,0,1,0],
			[0,1,1,1,0],
			[0,0,0,0,0]
		],
		[
			[1,1,1,1,1],
			[1,1,1,1,1],
			[1,1,0,1,1],
			[1,1,1,1,1],
			[1,1,1,1,1]
		],
		[
			[0,0,0,1,0],
			[0,1,1,1,0],
			[1,1,1,0,1],
			[0,1,1,1,0],
			[0,0,0,1,0]
		],
		[
			[1,0,0,0,1],
			[1,0,0,0,1],
			[1,0,1,0,1],
			[1,0,0,0,1],
			[1,0,0,0,1]
		],
		[
			[1,0,1,1,1],
			[1,0,1,0,0],
			[1,1,1,1,1],
			[0,0,1,0,1],
			[1,1,1,0,1]
		]
	]
}